111111111111111111111111111
100E000000CC00001000C000001
1000000000CC000011111110111
1000000000CC00000000P000001
111111111111111111111111111