1111111111111111111111111111111111
1010000100000000010000100001000001
1000010111111001010000111011000011
1011110100001001010000001110001001
1000010100001100011101100010011001
1011110001000000010001000011110001
1010000101111111110001001000100011
1011100100000000010001011000101001
101000011111111101101101C111101011
101010000000000100101001E110001111
1011111100010001001010110000000001
1000000111110101000010011111110101
1000100100010101011111111000000001
111110011001010111000000P001001001
1000000000000100000110001001001001
1111111111111111111111111111111111